Arabic	ar
English	en
English	en-gb
Bengali	bn
Czech	cs
Danish	da
German	de
Greek	el
Spanish	es
Persian	fa
Finnish	fi
Tagalog (Filipino)	fil
French	fr
Hebrew	he
Hindi	hi
Hungarian	hu
Indonesian	id
Italian	it
Japanese	ja
Korean	ko
Malay	msa
Dutch	nl
Norwegian	no
Polish	pl
Portuguese	pt
Romanian	ro
Russian	ru
Swedish	sv
Thai	th
Turkish	tr
Ukrainian	uk
Urdu	ur
Vietnamese	vi
Chinese - Mandarin	zh-cn
Chinese - Mandarin	zh-tw